//MAP CONVERTED BY dmm2tgm.py THIS HEADER COMMENT PREVENTS RECONVERSION, DO NOT REMOVE
"c" = (
/obj/effect/landmark/interior/spawn/entrance{
	dir = 8;
	exit_type = /obj/structure/interior_exit/vehicle/clf_van/backright;
	name = "back right entrance marker";
	pixel_x = -32;
	tag = "back_right"
	},
/obj/item/ammo_casing,
/obj/item/ammo_casing,
/obj/item/ammo_casing,
/obj/item/ammo_casing,
/turf/open/shuttle/vehicle/floor_3_12,
/area/interior/vehicle/clf_van)
"e" = (
/obj/structure/interior_wall/clf_van{
	icon_state = "background_1";
	layer = 2.8
	},
/obj/effect/vehicle_roof/clf_van,
/turf/open/void/vehicle,
/area/space)
"f" = (
/obj/structure/interior_wall/clf_van{
	icon_state = "front_2"
	},
/turf/open/void/vehicle,
/area/space)
"h" = (
/obj/effect/landmark/interior/spawn/interior_viewport/simple{
	alpha = 100;
	pixel_y = -2
	},
/obj/item/ammo_casing,
/obj/item/ammo_casing,
/obj/item/ammo_casing,
/obj/structure/bed/chair/vehicle/comfy{
	dir = 1;
	pixel_x = -3;
	pixel_y = 1;
	buckling_x = -3;
	buckling_y = 1
	},
/obj/structure/bed/chair/vehicle/comfy{
	dir = 1;
	pixel_x = 17;
	pixel_y = 1;
	buckling_x = 17;
	buckling_y = 1
	},
/turf/open/shuttle/vehicle/floor_1_13,
/area/interior/vehicle/clf_van)
"i" = (
/obj/structure/interior_wall/clf_van{
	icon_state = "front_1"
	},
/turf/open/void/vehicle,
/area/space)
"j" = (
/obj/structure/interior_wall/clf_van{
	icon_state = "background_2";
	layer = 2.8
	},
/obj/effect/vehicle_roof/clf_van{
	icon_state = "roof_2"
	},
/turf/open/void/vehicle,
/area/space)
"n" = (
/obj/structure/interior_wall/clf_van{
	icon_state = "exterior_2";
	alpha = 50;
	layer = 5.2;
	pixel_y = 32
	},
/turf/open/void/vehicle,
/area/space)
"o" = (
/obj/structure/bed/chair/vehicle/comfy{
	pixel_x = 5;
	pixel_y = 17;
	buckling_x = 5;
	buckling_y = 17
	},
/obj/effect/vehicle_roof/clf_van{
	icon_state = "roof_3"
	},
/turf/open/shuttle/vehicle/floor_1_14,
/area/interior/vehicle/clf_van)
"r" = (
/obj/structure/interior_wall/clf_van{
	icon_state = "background_3";
	layer = 2.8
	},
/obj/effect/vehicle_roof/clf_van{
	icon_state = "roof_3"
	},
/turf/open/void/vehicle,
/area/space)
"s" = (
/obj/effect/landmark/interior/spawn/entrance{
	dir = 8;
	exit_type = /obj/structure/interior_exit/vehicle/clf_van/backleft;
	name = "back left entrance marker";
	pixel_x = -32;
	tag = "back_left"
	},
/obj/item/ammo_casing,
/obj/item/ammo_casing,
/obj/item/ammo_casing,
/obj/item/ammo_casing,
/obj/item/ammo_casing,
/obj/structure/largecrate/random/mini/ammo{
	pixel_x = -4;
	pixel_y = 11
	},
/obj/structure/sign/poster/clf{
	pixel_x = 7;
	pixel_y = 39
	},
/obj/effect/vehicle_roof/clf_van,
/turf/open/shuttle/vehicle/floor_3_11,
/area/interior/vehicle/clf_van)
"t" = (
/obj/effect/landmark/interior/spawn/entrance{
	dir = 1;
	exit_type = /obj/structure/interior_exit/vehicle/clf_van/left;
	name = "left entrance marker";
	pixel_y = 32;
	tag = "left"
	},
/obj/effect/landmark/interior/spawn/interior_viewport/simple/windshield{
	icon_state = "windshield_viewport_bottom";
	icon = 'icons/obj/vehicles/interiors/clf_van.dmi'
	},
/obj/effect/landmark/interior/spawn/vehicle_driver_seat{
	dir = 4;
	icon = 'icons/obj/vehicles/interiors/rt01_general.dmi';
	icon_state = "vehicle_seat";
	pixel_x = -1;
	pixel_y = 5
	},
/obj/effect/vehicle_roof/clf_van{
	icon_state = "front_roof_2"
	},
/turf/open/shuttle/vehicle/floor_3_11,
/area/interior/vehicle/clf_van)
"v" = (
/obj/structure/interior_wall/clf_van{
	icon_state = "interior_door";
	layer = 2.8
	},
/obj/effect/landmark/interior/spawn/interior_viewport/simple/windshield{
	icon = 'icons/obj/vehicles/interiors/clf_van.dmi'
	},
/obj/effect/vehicle_roof/clf_van{
	icon_state = "front_roof_1"
	},
/turf/open/void/vehicle,
/area/space)
"w" = (
/obj/structure/interior_wall/clf_van{
	icon_state = "front_3"
	},
/turf/open/void/vehicle,
/area/space)
"x" = (
/obj/structure/interior_wall/clf_van{
	icon_state = "back_2"
	},
/turf/open/void/vehicle,
/area/space)
"y" = (
/obj/effect/landmark/interior/spawn/entrance{
	alpha = 50;
	exit_type = /obj/structure/interior_exit/vehicle/clf_van/right;
	name = "right entrance marker";
	tag = "right"
	},
/obj/structure/prop/vehicle/rt01/console{
	pixel_x = 18;
	icon_state = "vehicle_console_alt"
	},
/obj/structure/bed/chair/vehicle/comfy{
	dir = 4;
	pixel_y = 10;
	buckling_x = -3;
	buckling_y = 10;
	pixel_x = -1
	},
/turf/open/shuttle/vehicle/floor_3_12,
/area/interior/vehicle/clf_van)
"z" = (
/obj/structure/interior_wall/clf_van{
	icon_state = "back_1"
	},
/turf/open/void/vehicle,
/area/space)
"E" = (
/obj/structure/interior_wall/clf_van{
	icon_state = "back_3"
	},
/turf/open/void/vehicle,
/area/space)
"F" = (
/obj/structure/interior_wall/clf_van{
	icon_state = "exterior_1";
	alpha = 50;
	layer = 5.2;
	pixel_y = 32
	},
/turf/open/void/vehicle,
/area/space)
"G" = (
/obj/structure/bed/chair/vehicle/comfy{
	dir = 1;
	pixel_x = 5;
	pixel_y = 1;
	buckling_x = 5;
	buckling_y = 1
	},
/turf/open/shuttle/vehicle/floor_1_14,
/area/interior/vehicle/clf_van)
"J" = (
/obj/structure/interior_wall/clf_van{
	icon_state = "exterior_3";
	alpha = 50;
	layer = 5.2;
	pixel_y = 32
	},
/turf/open/void/vehicle,
/area/space)
"M" = (
/obj/effect/landmark/interior/spawn/interior_viewport/simple{
	pixel_y = 30
	},
/obj/item/ammo_casing,
/obj/item/ammo_casing,
/obj/structure/bed/chair/vehicle/comfy{
	pixel_x = -3;
	pixel_y = 17;
	buckling_x = -3;
	buckling_y = 17
	},
/obj/structure/bed/chair/vehicle/comfy{
	pixel_x = 17;
	pixel_y = 17;
	buckling_x = 17;
	buckling_y = 17
	},
/obj/effect/vehicle_roof/clf_van{
	icon_state = "roof_2"
	},
/turf/open/shuttle/vehicle/floor_1_13,
/area/interior/vehicle/clf_van)
"O" = (
/turf/open/void/vehicle,
/area/space)
"V" = (
/obj/structure/interior_wall/clf_van{
	icon_state = "exterior_door";
	alpha = 50;
	layer = 5.2;
	pixel_y = 32
	},
/turf/open/void/vehicle,
/area/space)

(1,1,1) = {"
O
E
x
z
O
"}
(2,1,1) = {"
O
e
s
c
F
"}
(3,1,1) = {"
O
j
M
h
n
"}
(4,1,1) = {"
O
r
o
G
J
"}
(5,1,1) = {"
O
v
t
y
V
"}
(6,1,1) = {"
O
w
f
i
O
"}
