//MAP CONVERTED BY dmm2tgm.py THIS HEADER COMMENT PREVENTS RECONVERSION, DO NOT REMOVE
"c" = (
/obj/structure/prop/vehicle/rt01{
	pixel_x = -16;
	pixel_y = -15
	},
/obj/structure/bed/chair/vehicle/comfy/alt{
	dir = 1;
	pixel_x = -2;
	buckling_x = -2
	},
/obj/effect/landmark/interior/spawn/interior_viewport/simple{
	icon = 'icons/obj/vehicles/interiors/rt01_general.dmi';
	icon_state = "viewport_back_2";
	pixel_x = -7;
	pixel_y = 11
	},
/obj/effect/landmark/interior/spawn/entrance{
	dir = 8;
	exit_type = /obj/structure/interior_exit/vehicle/rt01/back;
	name = "back entrance marker";
	tag = "back_right";
	pixel_x = -32;
	pixel_y = 25
	},
/turf/open/shuttle/vehicle/floor_3_13,
/area/interior/vehicle/van)
"h" = (
/obj/structure/bed/chair/vehicle/comfy/alt{
	dir = 1;
	pixel_x = 4;
	buckling_x = 4
	},
/obj/structure/bed/chair/vehicle/comfy/alt{
	dir = 1;
	pixel_x = -15;
	buckling_x = -15
	},
/turf/open/shuttle/vehicle/floor_3_14,
/area/interior/vehicle/van)
"o" = (
/obj/effect/landmark/interior/spawn/interior_viewport/simple{
	icon = 'icons/obj/vehicles/interiors/rt01_general.dmi';
	icon_state = "viewport_back";
	pixel_y = 32
	},
/obj/effect/landmark/interior/spawn/entrance{
	dir = 1;
	exit_type = /obj/structure/interior_exit/vehicle/rt01;
	name = "left entrance marker";
	tag = "left";
	pixel_y = 32
	},
/turf/open/shuttle/vehicle/floor_1_11,
/area/interior/vehicle/van)
"s" = (
/obj/structure/bed/chair/vehicle/comfy/alt{
	pixel_x = -2;
	pixel_y = 17;
	buckling_x = -2;
	buckling_y = 17
	},
/obj/effect/landmark/interior/spawn/interior_viewport/simple{
	icon = 'icons/obj/vehicles/interiors/rt01_general.dmi';
	icon_state = "viewport_back_1";
	pixel_x = -7;
	pixel_y = 28
	},
/obj/effect/landmark/interior/spawn/entrance{
	dir = 8;
	exit_type = /obj/structure/interior_exit/vehicle/rt01/back;
	name = "back entrance marker";
	tag = "back_left";
	pixel_x = -32;
	pixel_y = -7
	},
/turf/open/shuttle/vehicle/floor_3_13,
/area/interior/vehicle/van)
"t" = (
/obj/effect/landmark/interior/spawn/vehicle_driver_seat{
	dir = 4;
	pixel_y = 5;
	icon = 'icons/obj/vehicles/interiors/rt01_general.dmi';
	icon_state = "vehicle_seat_alt"
	},
/obj/effect/landmark/interior/spawn/interior_viewport/simple/windshield{
	icon = 'icons/obj/vehicles/interiors/rt01_general.dmi';
	icon_state = "windshield_viewport_side_top";
	pixel_y = 31
	},
/obj/effect/landmark/interior/spawn/interior_viewport/simple/windshield{
	icon = 'icons/obj/vehicles/interiors/rt01_general.dmi';
	pixel_y = 33;
	pixel_x = 32
	},
/obj/effect/landmark/interior/spawn/interior_viewport/simple/windshield{
	icon = 'icons/obj/vehicles/interiors/rt01_general.dmi';
	icon_state = "windshield_viewport_front";
	pixel_y = 1;
	pixel_x = 32
	},
/turf/open/shuttle/vehicle/floor_3_13,
/area/interior/vehicle/van)
"y" = (
/obj/effect/landmark/interior/spawn/interior_viewport/simple/windshield{
	icon = 'icons/obj/vehicles/interiors/rt01_general.dmi';
	icon_state = "windshield_viewport_side";
	pixel_y = 1;
	alpha = 50
	},
/obj/structure/bed/chair/vehicle/comfy/alt{
	dir = 4;
	pixel_y = 10;
	buckling_x = -3;
	buckling_y = 10
	},
/obj/structure/prop/vehicle/rt01/console{
	pixel_x = 19
	},
/obj/effect/landmark/interior/spawn/interior_viewport/simple/windshield{
	icon = 'icons/obj/vehicles/interiors/rt01_general.dmi';
	icon_state = "windshield_viewport_bottom";
	pixel_y = 1;
	pixel_x = 32
	},
/turf/open/shuttle/vehicle/floor_3_13,
/area/interior/vehicle/van)
"G" = (
/obj/structure/interior_exit/vehicle/rt01/exterior{
	alpha = 50
	},
/obj/effect/landmark/interior/spawn/interior_viewport/simple{
	icon = 'icons/obj/vehicles/interiors/rt01_general.dmi';
	icon_state = "viewport";
	pixel_y = 2;
	alpha = 100
	},
/obj/effect/landmark/interior/spawn/entrance{
	alpha = 50;
	exit_type = /obj/structure/interior_exit/vehicle/rt01/exterior;
	name = "right entrance marker";
	tag = "right"
	},
/turf/open/shuttle/vehicle/floor_1_12,
/area/interior/vehicle/van)
"M" = (
/obj/structure/bed/chair/vehicle/comfy/alt{
	pixel_x = -15;
	pixel_y = 17;
	buckling_x = -15;
	buckling_y = 17
	},
/obj/structure/bed/chair/vehicle/comfy/alt{
	pixel_x = 4;
	pixel_y = 17;
	buckling_x = 4;
	buckling_y = 17
	},
/turf/open/shuttle/vehicle/floor_3_14,
/area/interior/vehicle/van)
"O" = (
/turf/open/void/vehicle,
/area/space)

(1,1,1) = {"
O
O
O
O
O
"}
(2,1,1) = {"
O
O
s
c
O
"}
(3,1,1) = {"
O
O
M
h
O
"}
(4,1,1) = {"
O
O
o
G
O
"}
(5,1,1) = {"
O
O
t
y
O
"}
(6,1,1) = {"
O
O
O
O
O
"}
